F 100 100 100

EA textures/bois4.xpm

CT textures/espace.xpm

C 190 190 190


R  800  800

NO textures/wood2.xpm

SO textures/wood.xpm


P textures/woodporte.xpm


WE textures/bois3.xpm


S textures/arbresprite.xpm

111111111111111111111111111111111
11011000100111000000000000N000001
110000110000111000100000110101111
1010000101010101010101011110000111
111111020200000000010000100000111
11101111001010111000000001000011
111110000000000000111021000011001
11111111111111111111111111111111
